##    # B#
## ## ## #
## ## #  #
## ##   ##
A  #######
