##    #    ##     B  #
## ## ## # ## #### # #
## ## #  #     ### # #
## ##   ### ##  ##   #
A  ##        ##    ###